1111111111111111111111111111111111111111111
100100C0000C1000000000000000000CCCC00000001
1C000111110010000000000000000000CCCC0000001
1P0011000000100000000000000CCCCC11110000001
100C000CCCC0011100CC00000000000000000000001
100C000000CCCC0000000000000CCCC00011CC00001
1110000000000000CCCCCC000000000000000000001
1111111111111111111111101100000000000000001
1000000000000000000000000001111100000000001
100000CCCCCCCCCCCCCC00000110000000000000001
10000000000000000000000000E0000000000000001
1111111111111111111111111111111111111111111