1111111111111111111
10000000C0000001111
1001011111000011111
10010000C0001111111
1001000000E00001111
10001111101100000P1
1111111111111111111